1111111111111
1E010000M00C1
1000000000001
10001111C0011
1000011110001
1P001100CC111
1111111111111