111111
1E0111
10C0P1
100001
111111
