1111111D1111111
1E010000000C001
100000010000001
1000111C1000011
100001CCC100001
1000111C1CC0001
100000000000001
1000000P0000001
1111111D1111111
