111111111111111
10010000000C0G1
100000000000001
10001111C000011
100V0111110000D
10001100CCCV001
100000000000001
1000000P0000001
1111111D1111111
