111111111111111
10010000000C0G1
100000E00000001
10001111C000011
D00V01111100001
10001100CCCV001
100000000000001
1000000P0000001
111111111111111
