1111111D1111111
110000000000001
100000000000001
100000000000001
100000010000001
100000000000001
100000000000GG1
100000000000GG1
1111111D1111111
